11111111111111111
10000000000000001
10000001E10000001
100P00C1000000001
11111111111111111