11111111111111
10000000000001
1C00000E000001
1P000000000001
11111111111111