11111111111111111
10000000000000001
1000000E000000001
100P00C0000000001
11111111111111111