1111111111111111111111111111111111111111
100000000000000000000000000000C000000001
100000C10E01000C01111111100000C000000001
100P000100010C0010000000100000C000000001
100000C1000100C000000000100000C000000001
100000C1000100C000000001000000C000000001
100000C1111100C000000010000000C000000001
100000C0000100C000000100000000C000000001
100000C0000100C000001000000000C000000001
100000C0000100C000010000000000C000000001
100000C0000100C000100000000000C000000001
100000C0000100C001000000000000C000000001
100000C0000100C011111111100000C000000001
100000C0000000C000000000000000C000000001
1111111111111111111111111111111111111111