111111111111111111111111111
100000000000000000000000001
100000C1010000C100000000001
100P0001CE0000C001000000001
100000C1110000C010000000001
100000C1000000C010000000001
111111111111111111111111111
