11111111111111111111111111111
1000000000000000C000000000001
10P0111111111111111110000C001
10001000C0000E000000000000001
10001011111111111111111111001
10001000000000C000C0000000001
11111111111111111111111111111